31 28
14.5 24 
14.5 15
############################
#............##............#
#.####.#####.##.#####.####.#
#*####*#####.##.#####.####*#
#.####.#####.##.#####.####.#
#..........................#
#.####.##.########.##.####.#
#.####.##.########.##.####.#
#......##....##....##......#
######.#####.##.#####.######
######.#####.##.#####.######
######.##*********.##.######
######.##.###oo###.##.######
######.##.#------#.##.######
------....#------#....------
######.##.#------#.##.######
######.##.########.##.######
######.##..........##.######
######.##.########.##.######
######.##.########.##.######
#............##............#
#.####.#####.##.#####.####.#
#.####.#####.##.#####.####.#
#*..##.......--.......##..*#
###.##.##.########.##.##.###
###.##.##.########.##.##.###
#......##....##....##......#
#.##########.##.##########.#
#.##########.##.##########.#
#..........................#
############################
